##########
----#-----
-------#--
-----#----
----------
----------
-------#--
----------
----------
-#----#---