-----#---------------#
-#--------#---#--#-#--
-------#--------------
--#-------#----------#
----#---#-----#-------
#----#-------###------
---------#---###--#---
--#--#-------###------
------------#---------
------#--------#--#---
#--#-----------#------
--------#--#----------
--#---------------#---
-------#--------------
#---#-----#----#-----#
----------------------
--#-----#----#-----#--
