--#---------#-------
----#---------#-----
-------#---------#--
-----#---------#----
--------------------
--------------------
-------#---------#--
----#---------#-----
--------------------
--------------------
--#---------#-------
----#---------#-----
-------#---------#--
-----#---------#----
--------------------
--------------------
-------#---------#--
----#---------#-----
--------------------
--------------------