-#---------#
-----#--#---
------------
-#---------#
----#-------
-------#----
------------
---#-------#
--------#---
###---------
-----#-----#
