#-##---#--#-----
----#-----------
----#-----------
----------------
----------------
----------------
----------------
----------------
----------------
----#-----------
-#-----#--------
----------#---#-
#---------##---#
------------#-#-
----#--------#--
---------#-#----